10 15
 0  0  0  0  0  0  0  0  0  0  0  0  0  0  0 
 0  1  1  2  2  3  3  0  4  4  5  5  6  6  0 
 0  7  7  8  8  9  9  0 10 10 11 11 12 12  0 
 0 13 13 14  0  0 14  0 15  0  0 15 16 16  0 
 0 17 17 18  0 18 19  0 19 20  0 20 21 21  0 
 0 22 22  0  0 23 23  0 24 24  0  0 25 25  0 
 0 26 26 27  0 27 28  0 28 29  0 29 30 30  0 
 0  1  1  2  0  0  2  0  3  0  0  3  4  4  0 
 0  5  5  6  6  7  7  0  8  8  9  9 10 10  0 
 0  0  0  0  0  0  0  0  0  0  0  0  0  0  0 
