10 15
 0  0  0  0  0  0  0  0  0  0  0  0  0  0  0 
 0  1  0  1  2  2  3  0  3  4  4  5  0  5  0 
 0  6  6  0  7  7  8  0  8  9  9  0 10 10  0 
 0 11 11 12  0 12 13  0 13 14  0 14 15 15  0 
 0 16 16 17 17  0  0  0  0  0 18 18 19 19  0 
 0 20 20 21 21  0  0  0  0  0 22 22 23 23  0 
 0 24 24 25  0 25 26  0 26 27  0 27 28 28  0 
 0 29 29  0 30 30  1  0  1  2  2  0  3  3  0 
 0  4  0  4  5  5  6  0  6  7  7  8  0  8  0 
 0  0  0  0  0  0  0  0  0  0  0  0  0  0  0 
