10 15
 1  1  1  1  2  2  2  2  3  3  3  0  3  4  0 
 4  4  4  5  0  5  5  5  0  6  6  0  6  6  0 
 7  7  7  0  0  0  7  0  0  0  8  0  8  8  0 
 8  9  0  0  0  0  0  0  0  0  0  0  9  9  0 
 9 10 10  0  0  0  0  0  0  0 10 10  0  0 11 
11  0  0  0  0  0  0  0  0 11 11 12 12 12 12 
13 13  0 13 13  0  0  0 14 14 14 14 15 15 15 
15 16  0 16 16 16  0 17 17 17 17 18 18 18 18 
19 19  0 19 19 20 20 20 20 21 21 21 21 22 22 
22  0  0  0 22 23 23 23 23 24 24 24 24  1  1 
