10 15
 0  0  0  0  0  0  0  0  0  0  0  0  0  0  0 
 0  1  1  2  2  3  3  4  4  5  5  6  6  7  0 
 0  7  8  8  9  9 10 10 11 11 12 12 13 13  0 
 0 14 14 15 15 16 16 17 17 18 18 19 19 20  0 
 0 20 21 21 22 22 23 23 24 24 25 25 26 26  0 
 0 27 27 28 28 29 29 30 30 31 31 32 32 33  0 
 0 33 34 34 35 35  1  1  2  2  3  3  4  4  0 
 0  5  5  6  6  7  7  8  8  9  9 10 10 11  0 
 0 11 12 12 13 13 14 14 15 15 16 16 17 17  0 
 0  0  0  0  0  0  0  0  0  0  0  0  0  0  0 
