5
芝麻开门
50 120 100
10 15
 0  0  0  0  0  0  0  0  0  0  0  0  0  0  0 
 0  1  1  2  2  3  3  0  4  4  5  5  6  6  0 
 0  7  7  8  8  9  9  0 10 10 11 11 12 12  0 
 0 13 13 14  0  0 14  0 15  0  0 15 16 16  0 
 0 17 17 18  0 18 19  0 19 20  0 20 21 21  0 
 0 22 22  0  0 23 23  0 24 24  0  0 25 25  0 
 0 26 26 27  0 27 28  0 28 29  0 29 30 30  0 
 0  1  1  2  0  0  2  0  3  0  0  3  4  4  0 
 0  5  5  6  6  7  7  0  8  8  9  9 10 10  0 
 0  0  0  0  0  0  0  0  0  0  0  0  0  0  0 
四分五裂
65 130 100
10 15
 0  0  0  0  0  0  0  0  0  0  0  0  0  0  0 
 0  1  0  1  2  2  3  0  3  4  4  5  0  5  0 
 0  6  6  0  7  7  8  0  8  9  9  0 10 10  0 
 0 11 11 12  0 12 13  0 13 14  0 14 15 15  0 
 0 16 16 17 17  0  0  0  0  0 18 18 19 19  0 
 0 20 20 21 21  0  0  0  0  0 22 22 23 23  0 
 0 24 24 25  0 25 26  0 26 27  0 27 28 28  0 
 0 29 29  0 30 30  1  0  1  2  2  0  3  3  0 
 0  4  0  4  5  5  6  0  6  7  7  8  0  8  0 
 0  0  0  0  0  0  0  0  0  0  0  0  0  0  0 
心连你我
70 140 80
 10 15
 1  1  2  2  3  3  4  4  5  5  6  0  6  7  0 
 7  8  8  9  9 10 10 11 11 12 12  0 13 13  0 
14 14 15 15 16  0  0 16  0  0 17  0 17 18  0 
18 19 19 20  0  0  0  0  0  0  0  0 20 21  0 
21 22 22 23  0  0  0  0  0  0  0 23  0  0 24 
24  0  0  0 25  0  0  0  0  0 25 26 26 27 27 
28 28  0 29 29 30  0  0  0 30 31 31 32 32 33 
33 34  0 34 35 35  1  0  1  2  2  3  3  4  4 
 5  5  0  6  6  7  7  8  8  9  9 10 10 11 11 
12  0  0  0 12 13 13 14 14 15 15 16 16 17 17 
审判十字
80 160 100
10 15
 1  1  2  2  3  0  3  4  4  0  5  5  6  6  7 
 7  8  8  9  0  9 10  0 10 11  0 11 12 12 13 
13 14 14  0 15 15 16  0 16 17 17  0 18 18 19 
19 20  0 20 21 21 22  0 22 23 23 24  0 24 25 
25  0 26 26  0  0  0  0  0  0  0 27 27  0 28 
28  0 29 29  0  0  0  0  0  0  0 30 30  0 31 
31 32  0 32 33 33 34  0 34 35 35  1  0  1  2 
 2  3  3  0  4  4  5  0  5  6  6  0  7  7  8 
 8  9  9 10  0 10 11  0 11 12  0 12 13 13 14 
14 15 15 16 16  0 17 17 18  0 18 19 19 20 20 
返璞归真
80 160 50
10 15
 0  0  0  0  0  0  0  0  0  0  0  0  0  0  0 
 0  1  1  2  2  3  3  4  4  5  5  6  6  7  0 
 0  7  8  8  9  9 10 10 11 11 12 12 13 13  0 
 0 14 14 15 15 16 16 17 17 18 18 19 19 20  0 
 0 20 21 21 22 22 23 23 24 24 25 25 26 26  0 
 0 27 27 28 28 29 29 30 30 31 31 32 32 33  0 
 0 33 34 34 35 35  1  1  2  2  3  3  4  4  0 
 0  5  5  6  6  7  7  8  8  9  9 10 10 11  0 
 0 11 12 12 13 13 14 14 15 15 16 16 17 17  0 
 0  0  0  0  0  0  0  0  0  0  0  0  0  0  0 
